9
9
10
0, 0, 0, 0, 0, 0, 1, 1, 1
0, 0, 0, 0, 1, 1, 3, -1, 2
0, 0, 0, 0, 2, -1, 6, -1, 4
0, 0, 0,0, 2, -1, -1, -1, -1
0, 0, 0, 0, 1, 3, -1, 5, 3
0, 0, 0, 0, 0, 1, 2, -1, 1
0, 0, 0, 0, 0, 0, 1, 1, 1
0, 0, 0, 0, 1, 1, 1, 0, 0
0, 0, 0, 0, 1, -1, 1, 0, 0

